8 8
5 4
4 4
11111111
10100011
10111011
10001011
1101**01
11010011
10101011
11111111
