8 8
2 5
4 3
11111111
11101111
10011111
1000*001
10010011
10*00111
10110111
11111111
