8 8
4 5
6 5
11111111
11000111
10110101
10101001
11100101
1100*0*1
10110101
11111111
